#SampleID	BarcodeSequence	LinkerPrimer	Description		
ATD1	TCAGCCTCAGCC	GTGTGYCAGCMGCCGCGGTAA	E_Quiroz_plate1_A1		
ATD2	TGCAGGGAACCG	GTGTGYCAGCMGCCGCGGTAA	E_Quiroz_plate1_A2		
ATD3	CAGCGCGGCTAG	GTGTGYCAGCMGCCGCGGTAA	E_Quiroz_plate1_A3		
ATD4	ATGGACCTAGCT	GTGTGYCAGCMGCCGCGGTAA	E_Quiroz_plate1_A4		
ATD5	CTAGCCCGTTCG	GTGTGYCAGCMGCCGCGGTAA	E_Quiroz_plate1_A5		
ATD6	ACGGGCACGACA	GTGTGYCAGCMGCCGCGGTAA	E_Quiroz_plate1_A6		
ATD7	TACGAGCCCTAA	GTGTGYCAGCMGCCGCGGTAA	E_Quiroz_plate1_A7		
ATD8	CAATGGTTTCTT	GTGTGYCAGCMGCCGCGGTAA	E_Quiroz_plate1_A8		
ATD9	ACCCAGTATGGT	GTGTGYCAGCMGCCGCGGTAA	E_Quiroz_plate1_A9		
ATD10	GAACAGCTCTAC	GTGTGYCAGCMGCCGCGGTAA	E_Quiroz_plate1_A10		
ATD11	GACGACATTTAG	GTGTGYCAGCMGCCGCGGTAA	E_Quiroz_plate1_A11		
MTD1	GCAGACGGAACC	GTGTGYCAGCMGCCGCGGTAA	E_Quiroz_plate1_A12		
MTD2	ATTGATATTGAT	GTGTGYCAGCMGCCGCGGTAA	E_Quiroz_plate1_B1		
MTD3	GACTGGAGATGG	GTGTGYCAGCMGCCGCGGTAA	E_Quiroz_plate1_B2		
MTD4	CGCCCGGGACAC	GTGTGYCAGCMGCCGCGGTAA	E_Quiroz_plate1_B3		
MTD5	CGCTCTTAACGG	GTGTGYCAGCMGCCGCGGTAA	E_Quiroz_plate1_B4		
MTD6	TATTAGCCTATC	GTGTGYCAGCMGCCGCGGTAA	E_Quiroz_plate1_B5		
MTD7	GTATTTCGGACG	GTGTGYCAGCMGCCGCGGTAA	E_Quiroz_plate1_B6		
MTD8	ACTAGCGTTCAG	GTGTGYCAGCMGCCGCGGTAA	E_Quiroz_plate1_B7		
